27 22
#############
#...........#    ########
#...d...s...######......#
#.......................#
#...d...b...######..g...#
#.....................s.#
#...........######......#
#.....g.....#    #...g..#
#...........#    #......#
#...........#    #......#
#####..###### #####...###
    #..#      #...##l###
    #g.#      #...##..##
    #..#      #.k.d....#
    #..#      #...##...##
  ###..####   #####.....#
  #.......#      #......#
  #.......#      #...@..#
  #.......#      #......#
  #g.h.a..#      #......#
  #.......#      #......#
  #########      ########
