76 32
 ###########
##.........##     ######                                ##########
#..@........#######....################               ###........###
#......................................#             ##............##
#...........######.....................###############..............##
#...........#    #..........................................###.......#
#...........#    #......########............................###.......#
##.........##    #......###...........#########..#####..............##
 ####...####     ##...#####..........##      ##..#  ##.............##
    #...#         #..#####.........##       ##..#    ###.........###
   ##...##        #................##       #..####     ###########
  ##.....##       ##...............##       #......####
 ##.......##       #...............##       #..........##
##.........#############...#########        #..######....##
#..........................##################..##    ##...################
#...............................................##   ##..................##
##.........#########...################.##########   ###.................##
 ##.......##       #...#      #................#       #.................##
  ##.....##        #...#      #................#       #.................##
   ##...##         #...#      #................#       #.................##
    #...#          #...#      #................#       #.................##
    #...#          #...#      #................#       #.................##
    #...#          #...#      #................#       ##############.#####
 ####.#########################################################.......#
##.........##     ##...#                                #######.#######
#...........#######....################               ###........###
#......................................#             ##............##
#...........######.....................###############..............###
#...........#    #....................................................#
#...........#    #......########......................................#
##.........##    #......###...........################................#
#######################################################################