25 20
                 #######
                #.......#
                #.......#
                 #.....#
                #.....#
               #.......#
              #.........#
              #.........#
              #.........#
   ######      #........#
  #.....##      #.......#
 #.......##     #......#
 #........#######......#
 #....................##
  ##..................#
   ##................##
    ##..............##
     ###############